feel for - współczuć
cut in - wciąć się w rozmowę
drop off - spadać (cena)
check in - zameldować się w hotelu
check out - zapłacić rachunek i opuścić hotel
check up on - sprawdzić co ktoś robi
cut down on - zmniejszyć (spożycie)
cut back - zmniejszyć (wydatki)
cut off - wyizolować się, odłączyć
cut out - pomijać
draw in - skracać (dni)
draw on - użyć swoje oszczędności
draw out - rozszerzyć
draw up - zatrzymać (pojazd) 
drop in - odwiedzić niespodziewanie
drop out of - zostać wydalonym skądś
eat into - zjeść część czegoś
fall back - wycofać się
fall back on - polegać na kimś/czymś, kiedy inne zawiodło
fall for - zakochać się w kimś
fall in - zapadać się
fall in with - zgadzać się
fall off - nie zgadzać się
fall on - atakować
fall out with - kłócić się
fall through - nie dojść do skutku
feel for - solidaryzować się
fit in - dopasować się do grupy ludzi
fit up/out - umeblować/wyposażyć
fly at - naskoczyć na kogoś 
fold up - fail or collapse
head off - zapobiegać
join up - zaciągnąć się do wojska
a bit of a dark horse - osoba z ukrytymi talentami
be for a high jump - zostać zaraz zreprymendowany
be in two minds about sth - nie móc się zdecydować
be sound asleep - być w głębokim śnie
be perfect image of sb - wyglądać identycznie do kogoś
before one can say Jack Robinson - turbo szybko
break the ice - przełamać pierwsze lody
eat one's heart out - być zazdrosnym/smutnym o coś
flog a dead horse - tracić czas na coś niepotrzebnego
fly off the handle - szybko się zdenerwować
get out of hand - stracić panowanie nad sobą
get the hang of it - wejść w nawyk robienia czegoś
go to one's head - zarozumieć się
grey matter - szare komórki
hand in glove with sb - być z kimś w bliskich relacjach
have a job to do smth - mieć problem ze zrobieniem czegoś
have many irons in the fire - mieć wiele bierzących możliwości/planów w jednym czasie
have one's heart in one's mouth - być o coś bardzo niespokojny
have time on one's hands - mieć wolny czas
hold one's horses - czekać, być cierpliwym
ill the ease - zawstydzony, zakłopotany
keep sth under one's hat - trzymać coś w sekrecie
keep up with the Joneses - rywalizować z kimś w statusie/majętności
lend sb a hand - pomóc komuś
like the back of one's hand - znać cos dobrze
lose heart - zniechęcić się, zwątpić
make head nor tail of - rozumieć coś
off the cuff - bez przygotowania 
stew in one's own juice - ponosić konsekwencje swoich czynów
straight from the horse's mouth - info z pierwszej ręki
have sb's hands full - mieć ręce pełne roboty
sth comes in handy - coś się przydaje
strike gold - trafić na żyłę złota
take to one's heels - brać nogi za pas
the ins and out - znać coś na wylot
